module maps

#load "blueprint.fs" //module blueprint
open blueprint

// NO. 1
let map1() =
    [| [| 1; 1; 1; 1; 1; 1; 1; 1; 1; |]
       [| 1; 1; 1; 1; 1; 1; 1; 1; 1; |]
       [| 1; 1; 1; 1; 1; 1; 1; 1; 1; |]
       [| 1; 1; 1; 1; 1; 1; 1; 1; 1; |]
       [| 1; 5; 0; 2; 0; 0; 0; 3; 1; |]
       [| 1; 1; 1; 1; 1; 1; 1; 1; 1; |]
       [| 1; 1; 1; 1; 1; 1; 1; 1; 1; |]
       [| 1; 1; 1; 1; 1; 1; 1; 1; 1; |]
       [| 1; 1; 1; 1; 1; 1; 1; 1; 1; |]
    |] |> array2D

let lvl1() = GameMap(map1())


// NO. 2
let map2() =
    [| [| 1; 1; 1; 1; 1; 1; 1; 1; 1; |]
       [| 1; 1; 1; 1; 1; 1; 1; 1; 1; |]
       [| 1; 1; 0; 0; 1; 1; 1; 1; 1; |]
       [| 1; 1; 0; 2; 1; 1; 1; 3; 1; |]
       [| 1; 5; 0; 0; 0; 0; 0; 3; 1; |]
       [| 1; 1; 1; 1; 0; 2; 0; 0; 1; |]
       [| 1; 1; 1; 1; 1; 1; 0; 0; 1; |]
       [| 1; 1; 1; 1; 1; 1; 1; 1; 1; |]
       [| 1; 1; 1; 1; 1; 1; 1; 1; 1; |]
    |] |> array2D

let lvl2() = GameMap(map2())


// NO. 3
let map3() =
    [| [| 1; 1; 1; 1; 1; 1; 1; 1; 1; |]
       [| 1; 1; 0; 0; 0; 1; 1; 1; 1; |]
       [| 1; 1; 0; 2; 0; 1; 1; 1; 1; |]
       [| 1; 1; 0; 0; 0; 1; 0; 3; 1; |]
       [| 1; 5; 0; 2; 0; 0; 0; 3; 1; |]
       [| 1; 1; 0; 0; 0; 1; 0; 3; 1; |]
       [| 1; 1; 0; 2; 0; 1; 1; 1; 1; |]
       [| 1; 1; 0; 0; 0; 1; 1; 1; 1; |]
       [| 1; 1; 1; 1; 1; 1; 1; 1; 1; |]
    |] |> array2D

let lvl3() = GameMap(map3())

let levels = [lvl1;lvl2;lvl3]
